{
  "West": [
    {
      "routes": 2
    },
    [
      "213085056",
      "1840734606",
      "1840734600",
      "1840734607",
      "1840734598",
      "1840734610",
      "1840734608",
      "213085056"
    ],
    [
      "213085056",
      "1840734608",
      "1840734610",
      "1840734598",
      "1840734607",
      "1840734600",
      "1840734606",
      "213085056"
    ]
  ],
  "East": [
    {
      "routes": 2
    },
    [
      "213085056",
      "1840734592",
      "1840734597",
      "1840734578",
      "1840734604",
      "1840734594",
      "1840734593",
      "213085056"
    ],
    [
      "213085056",
      "1840734593",
      "1840734594",
      "1840734604",
      "1840734578",
      "1840734597",
      "1840734592",
      "213085056"
    ]
  ]
}